13,13
GGGWWWWWWBYGW
WBGGWBBBGGYGG
BBWGWBWGBBGWW
YBGGGBWYBYWWG
YBGGWYBGGGBWG
GWBBWWWBGBWWW
BGWWYWBBWWGYW
WYBGBBBYGWBYW
YYBWWGBYWGBBG
YGGYBGGBWYGYW
WWGWBWBYYYBGY
BGGGBBBWGWWWB
GYBWBWYGYGYGB
